R 1500 800
F 0, 102, 51
C 0, 204, 204
NO ./sprites/bookshelf.xpm
WE ./sprites/S.xpm
EA ./sprites/dark_oak_log.xpm
SO ./sprites/brown_shulker_box.xpm

S2 ./sprites/chat.xpm
S3 ./sprites/SPRITE.xpm
S4 ./sprites/barrel.xpm
S5 ./sprites/orc07.xpm
SP ./sprites/doors_close.xpm
Sp ./sprites/doors_open.xpm
SAE1@ ./sprites/enemy_aim.xpm
SAE2@ ./sprites/enemy_shoot.xpm
SAM1# ./sprites/enemyPM_aim.xpm
SAM2# ./sprites/enemyPM_shoot.xpm
KY ./sprites/skybox/color-galaxy.xpm

1111111111111111111111111111111111111111111111111 1111111111111111
140000000000000000000000000000000000000000000000010001444444444441
100000000000000000000000000000000021000011100000003001444444444441
100001111111111111111111111100#@0000000000000000000001444444444441
100000000000000000000000000000000000000000000000003001000000000001
100000000000000000111100000000111000000000000000000001050000000001
105000000011111000000000000000000000000000000000003001000000000001
100000000000000000000000000000000002222222250000000001000000000001
1000000000000000000000011200000N000000000000000000000P000000000001
100000011111111111111100000000000000000000000000003001000000000001
100000000000002000000000000011P11p10000000000002000001000000000001
100000000000001111111111111000000000000000000000003001000000000001
100000000000001111111111111000000000000000000000000001000000000001
100000000000000000000000000000000000000000000000003001000000002001
141111111100000000000000000000023451000000000000000001444544444441
111111111111111111111111111111111111111111111111111111111011111111
                                                        101 
                            1111111111111111111111111111101
                            1555555555555510001000150011101
                            1000000000000015101010101011101
                            1000000555000010101010151011101
                            1111111151111110101010101511101
                            1111111100000555100010001005001
                            1111111111111111111111111111111
