R 10000 10000
F 0, 102, 51
C 0, 204, 204
NO ./cont/walls/bookshelf.xpm
WE ./cont/walls/S.xpm
EA ./cont/walls/dark_oak_log.xpm
SO ./cont/walls/N.xpm

S2 ./cont/foes/alien-1.xpm

111111111111111111
100000000000200001
100000000000000001
100200000002000001
100000000000000001
10000000W000000001
100000000000000001
111111111111111111
