R 1080 720

F 254, 6, 18
C 25, 12, 95

111111111111111
100000000000001
100110100000001
100000000100001
100E00000100001
111111111111111
