R 1080 720

F 254, 6, 18
C 25, 12, 95

111111111111111
100000000000001
100110000000001
100000001100001
10000N000000001
111111111111111
