R 1536 864

F 0, 102, 51

C 0, 204, 204
NO ./sprites/bookshelf.xpm
WE ./sprites/S.xpm
EA ./sprites/dark_oak_log.xpm
SO ./sprites/brown_shulker_box.xpm
SP2 ./sprites/chat.xpm
SP3 ./sprites/SPRITE.xpm
SP4 ./sprites/barrel.xpm
SP5 ./sprites/orc07.xpm

111111111111111111111111111111111111111111111111111111111111111111
140000000000000000000000000000000000000000000000000001444444444441
100000000000000000000000000000000021000011100000003001444444444441
100001111111111111111111111100000000000000000000000001444444444441
100000000000000000000000000000000000000000000000003001000000000001
100000000000000000111100000000000000000000000000000001050000000001
105000000011111000000000000000000000000000000000003001000000000001
100000000000000000000000000000000000000000000000000001000000000001
1000000000000000000000011200000E5000000000000000000001500000000001
100000011111111111111100000000000000000000000000003001000000000001
100000000000002000000000000000500000000000000002000001000000000001
100000000000001111111111111000000000000000000000003001000000000001
100000000000001111111111111000000000000000000000000001000000000001
100000000000000000000000000000000000000000000000003001000000002001
141111111100000000000000000000023451000000000000000001444444444441
111111111111111111111111111111111111111111111111111111111111111111
