R 1536 864

F 0, 102, 51

C 0, 204, 204
NO ./sprites/bookshelf.xpm
WE ./sprites/wall4.xpm
EA ./sprites/dark_oak_log.xpm
SO ./sprites/brown_shulker_box.xpm

111111111111111111111111111111111111111111111111111111111111111111
100000000000000000000000000000000000000000000000000000000000000001
100000000000000000000000000000000000000011100000000001000000000001
100001111111111111111111111100000000000000000000000000000000000001
100000000000000000000000000000000000000000000000000001000000000001
100000000000000000111100000000000000000000000000000000000000000001
1000000000111110000000000000000000E0000000000000000001000000000001
100000000000000000000000000000000000000000000000000000000111111111
100000000000000000000001111111111111111100000000000001000000000001
100000011111111111111100000000000000000000000000000000000000000001
100000000000000000000000000000000011111111110000000001000000000001
100000000000001111111111111000000000000000000000000100000000000001
100000000000001111111111111000000000000000000000000101000000000001
100000000000000000000000000000000000000000000000000000000000000001
101111111100000000000000000000000000000000000000000001000000000001
111111111111111111111111111111111111111111111111111111111111111111
